....................
....................
....................
....................
....................
....................
..........G.........
.........G.G........
.........#:#........
....................
....GGG.......GDG...
....~##.......~~~...
....................
.1............A...XA
#####:::::::########
