................................
................................
...............................X
.........................G...~:~
...................G....~~~.....
..................~~~...........
.......................G........
......................#~#.......
............................G...
...........................##...
........................#.......
...........................G....
..........................###...
......................G.........
.....................###........
.................G..............
................###.............
............G...................
...........###..................
.......G........................
......###.......................
...........##...................
................................
~~##################............
................................
~...............................
....~...........................
.......##::##...................
..G..............GGG........G...
::##..G.G.G.G....#:~............
......CG.G.GCG................G.
......~#~~#~~~................~.
...~~...........~:..........G...
..............................~:
BG.G....:::.....G.G...~.....G...
###~#...........#:#:..G.G..~~...
..........:...........~:~.......
.1..............................
####::..:..:.::::...............
