X...................
~...................
....................
.......##::##.......
..G..............G..
::##..G.G.G.G....#:#
......CG.G.GCG......
......~#~~#~~~......
...--...........-:..
....................
BG.G....:::.....G.G.
###~#...........#:#:
..........:.........
.1..................
####::..:..:.::::...
