X...................
~...................
....................
.......##::##.......
..G..............G..
#:##..G.G.G.G....#:#
.......G.G.GCG......
......--------......
...--...........--..
....................
BG.G............G.G.
####............#:##
....................
.1..................
#####::::::::::#::::
