.G..-..............X
.-..............#..#
....................
.......#::##........
..G..............G.D
..#.....G.G.G....###
.......G.G.GCG......
..........#-#.......
................--..
.......:..B.........
.....#..###.....G.G.
...#............#:#:
-...................
.1..................
###:::::::::::::::::
